NO ./img/n.xpm
SO ./img/s.xpm
WE ./img/w.xpm
EA ./img/e.xpm

F 220,0,4
C 225,30,5

1111111111111111111111111
1000000000110000000000001
1011000001110000000000001
100100000000000N000000001
1111111111111111111111111