NO ./img/00.xpm
SO ./img/00.xpm
WE ./img/00.xpm
EA ./img/00.xpm

F 220,100,0
C 225,30,0

        011111111111111111111111
        11000000001100000100000010
        1011000001110000000000001
        1001000000000000000000001
111111111111000001110000000000001
100000000000000001110111111111111
11110100111111011100000010001
11110100111111111101110010001
11000000110101S00000010000001
10000000000000001100100010001
10000000000000001101010010001
1100000111010101111101111000111
11110111 1110101 101111010001
11111111 1111111 111111111111